Value	Feature_ID	Language_ID	Comment	Loan	Cognate Set	Reference
nigin	1plexcl	klon				
pin	1plincl	klon				
na:n	1sg	klon				
egin	2pl	klon				
a:n	2sginformal	klon				
a:n	2sgpolite	klon				
eniʔ	3pl	klon				
gan	3sg	klon				
uguwar	_answer	klon				
təkeɲ	_askquestion	klon				
luk	_bark	klon				
nəwel	_bathe	klon				
ul gəwel	_batheachild	klon				
museŋ	_besilent	klon				
teh	_bite	klon				
mid magei tumi giteŋ ta	_bless	klon				
pu	_blow	klon				
mədur	_borrow	klon				
eken bəlin	_breathe	klon				
il pe	_burnclearla	klon				
leb	_burntoshine	klon				
gəput	_bury	klon				
il	_buy	klon				
be	_callout	klon				
gəlɔbei	_chaseaway	klon				
gelɔbei	_chaseawayto	klon				
umənain	_chew	klon				
mi igin	_choose	klon				
hil	_climb	klon				
mid	_climb	klon				
uter	_close	klon				
ad	_come	klon				
ma	_come	klon				
gɔhɔi	_commandoror	klon				
əda pu	_cook	klon				
gəlik	_count	klon				
luluk	_crouch	klon				
wir	_cry	klon				
te erin tɔbaŋ	_curse	klon				
ubin ubei	_curse	klon				
hɔd	_cut	klon				
təkuɲ	_cut	klon				
haban	_cutdown	klon				
toɲ	_dance	klon				
gandi ginta mui	_defend	klon				
əber	_die	klon				
wərin	_dig	klon				
gowai	_divide	klon				
əper	_dream	klon				
na	_drink	klon				
gəmuŋ	_drop	klon				
mahak	_eat	klon				
muŋ her	_fallfromabo	klon				
beɲ	_fallover	klon				
gebuk	_fight	klon				
təted	_float	klon				
təwil	_flow	klon				
lir	_fly	klon				
lus	_fold	klon				
mi əber	_freeze	klon				
gen	_give	klon				
agai	_go	klon				
gɔpuɲ	_grasp	klon				
boŋ	_grow	klon				
no data	_guard	klon				
məgih	_hear	klon				
gemui	_help	klon				
təʔuɲ	_hide	klon				
kub	_hit	klon				
pədeŋ gud	_hitdrum	klon				
gɔ puɲ	_hold	klon				
kur	_hunt	klon				
gɔkar gɔ ɔluk	_invite	klon				
təber	_kill	klon				
nagil	_know	klon				
əgar	_laugh	klon				
usəkɔl	_learn	klon				
gɔgətaɲ	_letgo	klon				
ta	_liedown	klon				
tin ak	_lietelluntr	klon				
ih es	_livebealive	klon				
imih	_livetostay	klon				
gɔʔas	_open	klon				
ge gɔ ənem	_own	klon				
ərak tek	_plantrice	klon				
tik	_plantyam	klon				
kukuih	_play	klon				
təpan	_poundtobeat	klon				
mɔp	_pray	klon				
tim təmeɲ	_promise	klon				
gəbik	_pull	klon				
gəjɔr	_push	klon				
gərum	_push	klon				
migijul	_refuse	klon				
ɔi	_rub	klon				
prenta	_ruleorgover	klon				
təkin	_run	klon				
gəlar	_sail	klon				
huih	_say	klon				
kəber	_scratch	klon				
əlil	_searchhuntf	klon				
geʔur	_see	klon				
tan	_sell	klon				
il hərot	_sew	klon				
leb	_shine	klon				
gətap	_shoot	klon	gətap 'shoot with arrow'			
mah	_shoot	klon	gətap 'shoot with arrow'			
gəpet	_shootwithsl	klon				
il pənen	_sing	klon				
mih	_sit	klon				
teɟ	_skewer	klon				
tiŋgen	_skewer	klon				
gəboŋ	_slap	klon				
ta mi mok	_sleep	klon				
muɲ məgih	_smell	klon				
huhuih	_speak	klon				
məler	_spit	klon				
hɔl	_split	klon				
kəmei	_squeeze	klon				
ədin	_squeeze	klon				
tek	_stab	klon				
mətih	_stand	klon				
təka	_steal	klon				
mi əruih	_suck	klon				
geluk	_surrender	klon				
uwar	_swell	klon				
wəren	_swim	klon				
gusəkɔl	_teach	klon				
uhuih uməteŋ	_tell	klon				
kirkir	_think	klon				
gud	_throw	klon				
pat	_tie	klon				
ɔlaŋ men sar	_tradeorbart	klon				
awar	_turn	klon				
gəwar	_turn	klon				
iŋ	_vomit	klon				
wəreb	_wait	klon				
gətiŋ	_wakesomeone	klon				
mətih	_wakeup	klon				
lam	_walk	klon				
uhan	_wash	klon				
uwel	_wash	klon				
gədiŋ mərhaɲ	_weave	klon				
muhaha	_whisper	klon				
ukei umur gɔkei	_wipe	klon				
krejaŋ	_work	klon				
mɔp	_worship	klon				
ak	_yawn	klon				
ətal ta:ŋ	above	klon				
kəla	accuse	klon				
kənit a:k	afew	klon				
ʔi al	all	klon				
de	and	klon				
gi həla kəlik	angry	klon				
no data	animal	klon				
nərik	ant	klon				
tətan	arm	klon				
kəbur	arrow	klon				
ɔk	at	klon				
bei	axe	klon				
təmot	back	klon				
jah	bad	klon				
pi:t	bamboo	klon				
mɔgol	banana	klon				
no data	barkoftree	klon				
əwi nok	barnstorage	klon				
mədel	bat	klon				
taʔa:	bean	klon				
ut	bean	klon				
de hɔ	because	klon				
lip	bed	klon				
təmek	bedbug	klon				
əma:i mi	below	klon				
bu:i	betelnutare	klon				
meh	betelvine	klon				
al	big	klon				
hi ʔidɔm	bird	klon				
məkal	bitter	klon				
ʔa ʔakan	black	klon				
gen ja	blind	klon				
wi:	blood	klon				
wəleŋ	blue	klon				
kum	bluntdull	klon				
tiʔih bok	body	klon				
tiʔih əmuɟ	bodyhair	klon				
tərɔk	bone	klon				
pe	bow	klon				
əti gətan	branch	klon				
ətɔn kul	breadfruit	klon				
du:t	breast	klon				
gɔn haha:l	brideprice	klon				
həbur	broomsweep	klon				
gi eduɲ	brother	klon				
genaɟ	brotherinla	klon				
təlɛ miʔil aʔan	burdenstick	klon				
kəkowak	butterfly	klon				
pan	candle	klon				
ɛi	canoe	klon				
atik ku	cassava	klon				
kəder	chair	klon				
il əmai	cheap	klon				
tadia:r	cheek	klon				
tider	chest	klon				
il ha:n	chewbetel	klon				
hi	chicken	klon				
aram gi kədeh	chieftain	klon				
məmənak	child	klon				
ta:d giki	chin	klon				
gəreɟ	church	klon				
eruk	civetcat	klon				
əlɔr	clan	klon				
higetak	claw	klon				
tet	claw	klon				
mkɛi kan	clay	klon				
mohɔl	clean	klon				
nai	clean	klon				
pəkar	clothing	klon				
ti ʔik	cloud	klon				
əta:	coconut	klon				
kəbuk	cold	klon				
mehiŋ	cold	klon				
madeb	coldinfluen	klon				
kir	comb	klon				
ten ki:k	conjunctivi	klon				
bat ip ma:i	cookedcorn	klon				
ərak ma:i	cookedrice	klon				
əda gen	cookhouseki	klon				
kɔka	coralreef	klon				
wɔr kɔka	coralrock	klon				
bat	cornmaize	klon				
ih əben	correct	klon				
bəgai	crocodile	klon				
gekarnɔk	crosscousin	klon				
no data	cuscus	klon				
kəraŋ	dark	klon				
mədi	day	klon				
əruk	dayaftertom	klon				
ise ruk	daybeforeye	klon				
gəwir kukuih	deaf	klon				
ərut	deer	klon				
təkɔr	difficult	klon				
mkei huhub	diggingstic	klon				
muk	dirty	klon				
kur	dog	klon				
no data	dolphin	klon				
hek	door	klon				
gɔbuh gɔhowar	dowry	klon				
ənur iʔikin	drizzle	klon				
təkat	dry	klon				
upur	dryinsun	klon				
edur	dustfineear	klon				
təwi:r	ear	klon				
əla	earring	klon				
bulja	earth	klon				
dai mədek	earthquake	klon				
dəlikwei	earthworm	klon				
ih iwil	easy	klon				
ədaŋ	egg	klon				
tid əruk	eight	klon				
karnuk əwa tid əruk	eighteen	klon				
kar tid əruk	eighty	klon				
karnuk əwa nuk	eleven	klon				
ikuh	empty	klon				
ele	enemy	klon				
əhi:	excrement	klon				
il təkɔr	expensive	klon				
tɛn	eye	klon				
let	far	klon				
təma:d	fat	klon				
niman	father	klon				
man gi edɔl	fatherssist	klon				
hi wərek	feather	klon				
a	fence	klon				
təbir	feverish	klon				
mətei	field	klon				
karnuk əwa aweh	fifteen	klon				
kar əweh	fifty	klon				
tətan kərik	finger	klon				
tətan kuih	fingernail	klon				
ikuih	finished	klon				
ada wer	fire	klon				
ədur	fireplaceas	klon				
əda:ku	firewood	klon				
əbi	fish	klon				
ewɛl	fishinghook	klon				
dəlaŋ	fishnet	klon				
nɛdaŋ delaŋ meniŋ	fishtrap	klon				
əwih	five	klon				
bur	flat	klon				
kai hib	flea	klon				
kɔt	flea	klon				
put	fleshmeat	klon				
ɔt gomi	floor	klon				
əti bu:ŋ	flowerinegm	klon				
mədel	flyinfoxfru	klon				
bəlel	flyn	klon				
əlak	foam	klon				
tiʔik	fog	klon				
tetak	foot	klon				
ten məra	forehead	klon				
bui	forest	klon				
ɛh	forest	klon				
kar ut	forty	klon				
ut	four	klon				
karnuk əwa ut	fourteen	klon				
hiʔidom	fowl	klon				
le	friend	klon				
tininuk	friend	klon				
eil pek	frog	klon				
no data	fruit	klon				
umi	full	klon				
ter	garden	klon				
lahtal	god	klon				
nɔk	good	klon				
no data	graincereal	klon				
dat	grandchild	klon				
datja	grandchild	klon				
nidum	grandfather	klon				
nidɔl	grandmother	klon				
kwil	grassbrush	klon				
təkɛt	grasshopper	klon				
wor mlat	gravel	klon				
wəleŋ	green	klon				
əlɔr al	groundforri	klon				
gahal	guilty	klon				
ni:h	gumtreeeuca	klon				
gɛh gətu:k	guts	klon				
a:k bok	gwang	klon				
titu kərid	hair	klon				
tetan	hand	klon				
gitu	head	klon				
əkoɲ	headlice	klon				
ta:kub	heart	klon				
təkɔr	heavy	klon				
temɔ uɟ	heeloffoot	klon				
jɔŋ mi	here	klon				
dədɔl	hillridge	klon				
dɔk	hole	klon				
nai mahɔl	holy	klon				
məgar əra:	honey	klon				
gəmuk	horn	klon				
tut	hot	klon				
midi	hour	klon				
əwi	house	klon				
tujɔn bo	how	klon				
edin	howmuchhowm	klon				
nebet eliŋ	hungry	klon				
om	husband	klon				
ərak mem	huskedriceu	klon				
es	ice	klon				
no data	if	klon				
gomi	ininside	klon				
agam bahar	initiationc	klon				
hok gahal naŋ	innocent	klon				
buk	island	klon				
kak	itchy	klon				
nəlem	itchy	klon				
ətɔn	jackfruit	klon				
ler	kingruler	klon				
te ukəbal	knee	klon				
dur	knife	klon				
raja	lake	klon				
mihi	lamp	klon				
məkɛi	landsoil	klon				
huh	language	klon				
knuih	lazy	klon				
əti wɛi	leaf	klon				
ik	leftside	klon				
tetak	leg	klon				
bəlɔk	light	klon				
mədek	lightning	klon				
əwil	lightweight	klon				
əwɛr	lime	klon				
tetabɔd	lips	klon				
nəbur	liver	klon				
takek	lizard	klon				
dəram	locust	klon				
laŋ	longstick	klon				
tɔk bok	lontarpalm	klon				
hep bəli	loom	klon				
ur	louseclothi	klon				
əkoɲ kədiŋ	louseeggs	klon				
kəlɛd	lungs	klon				
ped	machete	klon				
om kənei	man	klon				
mogoi	mango	klon				
obei	many	klon				
ənu gɛn	market	klon				
tin med tin puɲ	marriage	klon				
kɔkɔl	marungga	klon				
wik	mat	klon				
om əwi laŋ jar	meetinghous	klon				
du:t	milk	klon				
klak	millet	klon				
dui	money	klon				
wərih	monitorliza	klon				
ur	moon	klon				
kukun	morning	klon				
mesɟid	mosque	klon				
ikin	mosquito	klon				
nɔi	mother	klon				
əkoɲ gɔi	motherlouse	klon				
majar	mothersbrot	klon				
dur	moundofston	klon				
dɔl	mountain	klon				
ta:d	mouth	klon				
hin	mucus	klon				
mul	mud	klon				
təniʔ	name	klon				
təpuih	narrowroad	klon				
təpuh igen	navel	klon				
tətab	near	klon				
tidɔ həla:	neck	klon				
bab	necklace	klon				
bah	needle	klon				
dɔd	nephewniece	klon				
əwi həba	newhouse	klon				
akaan	night	klon				
tuk ənuk	nine	klon				
karnuk əwa tuk ənuk	nineteen	klon				
kar tuk enuk	ninety	klon				
naŋ	nonot	klon				
təmuɲ	nose	klon				
temuɲ dɔk	nostril	klon				
wid jɔŋ	now	klon				
ɔm om	olderbrothe	klon				
niɔm	oldersiblin	klon				
ɔm ɔl	oldersister	klon				
kul bin	oldpeople	klon				
əwi məlot	oldwornhous	klon				
nuk	one	klon				
eska nuk	onehundred	klon				
eska nuk kar əruk əwa tɔŋ	onehundreda	klon				
rib eska nuk	onehundredt	klon				
ada gen	ovencooking	klon				
tətan mərei	palmofhand	klon				
etemɔl	papaya	klon				
gahal mənaŋ	penalty	klon				
tətɔpa:k	penis	klon				
aninɔk	person	klon				
be	pig	klon				
gunaŋ gab naŋ	poor	klon				
geʔil	price	klon				
pandita	priestmoder	klon				
hek	rackabovehe	klon				
ɔn hek	rackabovehe	klon				
ənur	rain	klon				
ədub	rainbow	klon				
lip	raisedplatf	klon				
dur	rat	klon				
ʔuhul	rattan	klon				
kikik	red	klon				
degɛt	rib	klon				
ter	ricefield	klon				
ərak lid	ricegrainsu	klon				
ərak əniŋ	riceplant	klon				
kakawah	rich	klon				
kɔr	ridgepolepe	klon				
tənei	rightside	klon				
kat	ringworm	klon				
əten mai	ripe	klon				
əten əgai	ripe	klon				
wer	riverstream	klon				
egek	roadpathway	klon				
no data	roofthatch	klon				
no data	root	klon				
hala	rope	klon				
gəmuɲ mai	rotten	klon				
muɲ əgai	rotten	klon				
i ətak	rough	klon				
kuib	round	klon				
gɔluk gɔhɔl	sacrifice	klon				
no data	sago	klon				
lar	sailn	klon				
əhi:r	salt	klon				
ətɔl	salty	klon				
munuk	same	klon				
alat	sand	klon				
ken	sarongwomen	klon				
kat	scabies	klon				
nedan	scared	klon				
per	scorpion	klon				
tan	seaseawater	klon				
no data	seed	klon				
wom uhuih	sermon	klon				
usɔŋ	seven	klon				
karnuk əwa usɔŋ	seventeen	klon				
kar usɔŋ	seventy	klon				
hib	shark	klon				
maŋ	sharp	klon				
bad	shirt	klon				
uʔur	shortpeople	klon				
uʔur	shortstick	klon				
ti kəbel	shoulder	klon				
edadan	shyashamed	klon				
kəlik	sickpainful	klon				
gi edɔl	sister	klon				
təlan	six	klon				
karnuk əwa təlan	sixteen	klon				
kar təlan	sixty	klon				
ku:i	skin	klon				
mot	skinnyhuman	klon				
bulgɛn	sky	klon				
bah	slave	klon				
kənit	small	klon				
ada bon	smoke	klon				
təduil	smooth	klon				
mun	snake	klon				
tuit tʔek	snow	klon				
te mərei	soleoffoot	klon				
haharam	sorcererwit	klon				
abat	sorewound	klon				
əlur	sour	klon				
kəbak	spear	klon				
nəwak	spider	klon				
təme hia:r	spinelowerb	klon				
ib	star	klon				
no data	starfish	klon				
dob	stickpole	klon				
gəbɛd	stomachbell	klon				
wɔr	stone	klon				
nəmud	straight	klon				
gen ib gəpɔn əbiŋ	stranger	klon				
əba:	sugarcane	klon				
na bok	sugarpalm	klon				
mədi	sun	klon				
a:ŋ	sweat	klon				
dəri	sweet	klon				
kɛsɛl	sweetpotato	klon				
gɔr kei	tail	klon				
laŋ	tallperson	klon				
le	taro	klon				
tɛn enu:k	tear	klon				
təwih	teeth	klon				
karnuk	ten	klon				
tətɔk ədaŋ	testicles	klon				
jɔk	that	klon				
no data	thatchroof	klon				
təbur	theadultery	klon				
hakim	thejudge	klon				
təber	themurder	klon				
jok mi	there	klon				
təlek	thewarorbat	klon				
təpeh	thick	klon				
tik	thinnonhuma	klon				
nəmen təkat	thirsty	klon				
karnuk əwa tɔŋ	thirteen	klon				
kar tɔŋ	thirty	klon				
jɔŋ	this	klon				
rib nuk	thousand	klon				
kap	thread	klon				
tɔŋ	three	klon				
wlaŋ	thunder	klon				
kat	tinea	klon				
wra	tomorrow	klon				
təli:b	tongue	klon				
ɔm əwi laŋ jar	traditional	klon				
tawum tabei	treaty	klon				
əti	tree	klon				
dek gilaŋ	trousers	klon				
jekɔ	turtle	klon				
jekɔ	turtlesaltw	klon				
karnuk əwa aruk	twelve	klon				
kar əruk	twenty	klon				
kar əruk əwa aweh	twentyfive	klon				
kar əruk əwa ut	twentyfour	klon				
kar əruk əwa nuk	twentyone	klon				
kar əruk əwa tɔŋ	twentythree	klon				
kar əruk əwa aruk	twentytwo	klon				
kun kun ilmikəraŋ	twilightdaw	klon				
əruk	two	klon				
eska aruk	twohundred	klon				
ta:r	vagina	klon				
tu:r	vein	klon				
əben	village	klon				
gemaŋ	voice	klon				
teh ab	waist	klon				
əlei	wall	klon				
əra	waterfresh	klon				
bɔb	wave	klon				
jel	wet	klon				
kəlar	whale	klon				
nabe	what	klon				
dendi	when	klon				
atubomi; atu mi ad	where	klon	atubomi 'where'; atu mi ad 'from where'			
tumi	where	klon	atubomi 'where'; atu mi ad 'from where'			
ʔa ʔijal	white	klon				
ʔaʔabe	who	klon				
tujɔn	why	klon				
ərek	wide	klon				
nɔl	wife	klon				
nəmer	wind	klon				
bukɔldok	window	klon				
gambal	wing	klon				
no data	with	klon				
ɔk kənei	woman	klon				
gɔi al	womanscross	klon				
gɔi kəkeɲ	womanscross	klon				
ɔl gegik ɔl	womansyoung	klon				
əti bɔk	wood	klon				
huih men	word	klon				
gəhal	wrong	klon				
tun	year	klon				
bugur	yellow	klon				
məlɛŋ	yesterday	klon				
ik om	youngerbrot	klon				
ninik	youngersibl	klon				
ɔl at boŋ heb	youngpeople	klon				
